1111111111111111111111111111111111111111
1111111111111111111111111111111111111111
1P00110000000001110000000000001100000C11
1000110000000001100000000000001100000011
1100110011111001100111111111001100110011
1100110011111101100111111111001100110011
1100110000001100000110000000001100110011
1100110000001100000110000000001100110011
1100110011001111111110011111111100110011
1100110011001111111110011111111100110011
1100000011000000000110000000001100110011
1100000111000000000110000000001100110011
1100111111111111100111111111111100110011
1100111111111111100111111111111100110011
1100110000000001100000000001000000110011
1100110011111001111111111001000111110011
1100110011111101111111111001001111110011
1100000011011100000110000001001100000011
1100000011C01100000110000001001100000011
1111110011001111100110011111001111111111
1111110011001111100110011111001111111111
1100000011001100000110000000001100000011
1100000011001100000110000000001100000011
1100111111001101111111111111111100110011
1100111111001101111111111111111100110011
1100110000001100000000011000000000110011
1100110000011100000000011000000000110011
1100110011111111100110011001111100110011
1100110000000001100110000001100000110011
1100110000000001100110000001000000110011
1100111111111001100111111001001111111111
1100111111111101100111111001001111111111
1100000000000001100000011001000000000011
1100000000000001100000011001000000000011
1111111111111111111110011001111111110011
1111111111111111111110011001111111110011
1100000000000000000000011000000000110001
11C00000000000000000000110000000001100E1
1111111111111111111111111111111111111111
1111111111111111111111111111111111111111
