111111111111111111111111111111111111111111111
1P0000000000000000000000000000000000000000CE1
110101010101010101010101010101010101010101011
101010101010101010101010101010101010101010101
110101010101010101010101010101010101010101011
101010101010101010101010101010101010101010101
110101010101010101010101010101010101010101011
101010101010101010101010101010101010101010101
110101010101010101010101010101010101010101011
101010101010101010101010101010101010101010101
110101010101010101010101010101010101010101011
101010101010101010101010101010101010101010101
110101010101010101010101010101010101010101011
101010101010101010101010101010101010101010101
110101010101010101010101010101010101010101011
101010101010101010101010101010101010101010101
110101010101010101010101010101010101010101011
101010101010101010101010101010101010101010101
110101010101010101010101010101010101010101011
101010101010101010101010101010101010101010101
111111111111111111111111111111111111111111111