1111111111111
10010000000C1
100001111100111
1P0011E00000101
111111111111111