11111111111111111111111111111111111111111111
11111111111111111111111111111111111111111111
11111111111111111111111111111111111111111111
11111111111111111111111111111111111111111111
11111111111111111111111111111111111111111111
11111111111111111111111111111111111111111111
11111111111111111111111111111111111111111111
11110000000000000000000000000000000001111111
11110000000000000000000000000000000001111111
11110000000000000000000000000000000001111111
11110000000000000000000000000000000001111111
11110000000000000000000000000000000001111111
11110000000000000000000000000000000001111111
11110000000000000000000000000000000001111111
11110000000000000000000000000000000001111111
11110000000000000000000000000000000001111111
11110000000000000000000000000000000001111111
11110000000000000000000000000000000001111111
11110000000000000000000000000000000001111111
11110000000001111101100000000000000001111111
11110000000001110001100000000000000001111111
11110000000001100001100000000000000001111111
11110000000000000001100000000000000001111111
11110000000000000001100000000000000001111111
11110000000000000011100000000000000001111111
11110000000000000111100000000000000001111111
11110000000000011110000000000000000001111111
11110000000001111000000000000000000001111111
11110000000111000000000000000000000001111111
11110000000111000000000000000000000001111111
11110000000111000001100000000000000001111111
11110000000111000011100000000000000001111111
11110000000111001111100000000000000001111111
11110000000000000000000000000000000001111111
1111000000000000000000000000P000000001111111
1111000000000000000000000000E000000001111111
1111000000000000000000000000C000000001111111
11110000000000000000000000000000000001111111
11110000000000000000000000000000000001111111
11110000000000000000000000000000000001111111
11110000000000000000000000000000000001111111
11110000000000000000000000000000000001111111
11110000000000000000000000000000000001111111
11111111111111111111111111111111111111111111
11111111111111111111111111111111111111111111
11111111111111111111111111111111111111111111
11111111111111111111111111111111111111111111
11111111111111111111111111111111111111111111
11111111111111111111111111111111111111111111
11111111111111111111111111111111111111111111