111111111111111111111111111111111111111111111111111
111111111111111111111111111111111111111111111111111
111111111111111111111111111111111111111111111111111
111111111111111111111111111111111111111111111111111
111111111111111111111111111111111111111111111111111
111111111111111111111111111111111111111111111111111
111111111111111111111111111111111111111111111111111
111100000000000000000000000000000000011111111111111
111100000000000000000000000000000000011111111111111
111100000000000000000000000000000000011111111111111
111100000000000000000000000000000000011111111111111
111100000000000000000000000000000000011111111111111
111100000000000000000000000000000000011111111111111
111100000000000000000000000000000000011111111111111
111100000000000000000000000000000000011111111111111
111100000000000000000000000000000000011111111111111
111100000000000000000000000000000000011111111111111
111100000000000000000000000000000000011111111111111
111100000000000000000000000000000000011111111111111
111100000000011111011000000000000000011111111111111
111100000000011100011000000000000000011111111111111
111100000000011000011000000000000000011111111111111
111100000000000000011000000000000000011111111111111
111100000000000000011000000000000000011111111111111
111100000000000000111000000000000000011111111111111
111100000000000001111000000000000000011111111111111
111100000000000111100000000000000000011111111111111
111100000000011110000000000000000000011111111111111
111100000001110000000000000000000000011111111111111
111100000001110000000000000000000000011111111111111
111100000001110000011000000000000000011111111111111
111100000001110000111000000000000000011111111111111
111100000001110011111000000000000000011111111111111
111100000000000000000000000000000000011111111111111
111100000000000000000000000000000000011111111111111
111100000000000000000000000000000000011111111111111
111100000000000000000000000000000000011111111111111
111100000000000000000000000000000000011111111111111
111100000000000000000000000000000000011111111111111
111100000000000000000000000000000000011111111111111
111100000000000000000000000000000000011111111111111
111100000000000000000000000000000000011111111111111
111100000000000000000000000000000000011111111111111
111111111111111111111111111111111111111111111111111
111111111111111111111111111111111111111111111111111
111111111111111111111111111111111111111111111111111
111111111111111111111111111111111111111111111111111
111111111111111111111111111111111111111111111111111
111111111111111111111111111111111111111111111111111
111111111111111111111111111111111111111111111111111
111111111111111111111111111111111111111111111111111