1111111111111
1E10C010000E1
1010101011111
101S101010001
1010101010101
1010101000101
1010101111101
100000L000001
1011111011111
1000001000001
1111101011101
1000001000101
1011111010101
10000C10101C1
1011111010111
100000101S1C1
1111101010101
1000001010101
1011111010101
1P000C10000P1
1111111111111
