111111111111111111111111
1E000101001C1C00010001E1
111101000100100101010101
100001000000100000010101
101000010100100100010001
1001000P1000100P10000001
100010000000100000000001
111111111111111111111111
1L000000001SCS10000000L1
111111111110P01111111111
100000000L1SES1000000001
111111111111111111111111
100000000000100000000001
1000000P1000100P00000001
100010000000110100001111
101010100010101010100001
101010100100100010101111
1E100010000C1C00001000E1
111111111111111111111111