11111111111111111111111111111111111
10000000000000000000000000000000001
10000000000000000000000000000000001
10000000000000000000000000000000001
10000000000000000111100001111101101
10000000000000001110000001110001101
10000000000000111000000001100001101
10000000000001110000000000000001101
10000000000111000000000000000001101
10000000001110000000000000000001101
10000000111000000000000000000001101
10000011110000000000000000000011101
10000111000000000000000000000111101
10011100000000000000000000011110001
10111000000000000000000001111000001
10111111111111111110000111000000001
10111111111111111110000111000000001
10000000000000000110000111000001101
10000000000000000110000111000011101
10000000000000000110000111001111101
100000000000000C0110000000000000001
100000000000000P0110000000000000001
100000000000000E0110000000000000001
10000000000000000000000000000000001
11111111111111111111111111111111111