1111111111
1000C00001
1000000E01
10P0000001
1111111111