1111111111111
1001000000LC1
1000011111LL1
1P0011E000001
1111111111111