1111111111111
1P010000000C1
1P00011111001
1L0011E0000S1
1111111111111