111111111111111111111
10000E0000100000E0001
100000L000100000000L1
1001010100100000L0001
1L0000000010001C10001
101C101C1010L00000001
10000L000010010101001
10010101001000L000001
100000L00010101010101
10101C10101000L000001
100000000010010101001
1001S1S10010000L00001
1000000L00101C1S1C101
101010101010000000001
100L00000010010101001
100101010010000L00001
10000L000010101010101
10101010101000L000001
100000L00010010101001
1001010100100000L0001
100000P00010000P00001
111111111111111111111