1111111
1000C01
100E001
10P0001
1000001
1000001
1000001
1000001
1000001
1000001
1000001
1000001
1000001
1000001
1111111